...+.+.+...
...........
+.+.+.+.+.+
.....@.....
+.+.+.+.+.+
...........
+.+.Q.+.+.+
...........
.e.+.+.+...
.....e.....