....+.+.+..
...........
+.+.+.+.+.+
...........
+.+.+.@.+.+
...........
+.+.Q.+.+.+
...........
.e..+.+.+..
.....e.....