.e.......e.
...........
.+++++++++.
.....+.....
...........
.+++++++++.
...........
.....+.....
.+++++++++.
.....@.....