++++++++++++++++++++
+e.......++.......e+
+........++........+
+........++........+
++++++++++++++++++++
++++++++++++++++++++
+........++........+
+........++........+
+e.......++.......@+
++++++++++++++++++++