++++++++++++++++++++
+e.......++.......e+
+........++........+
+........++........+
+++++++++QQ+++++++++
+++++++++QQ+++++++++
+........++........+
+........++........+
+e.......++.......@+
++++++++++++++++++++