@.............e
+++++..++++++++
....+..+.......
....+..+.+++++.
+++++..+.+.....
+......+.+++...
+..+++++.+.....
.........+.....
..............e
.............ee