+....e....+
.+.......+.
..+.....+..
...+...+...
....+.+....
.....@.....
....+.+....
...+...+...
..+.....+..
.+.......+.
+....e....+